111111
1P00E1
101101
100001
100001
101101
100001
100101
101001
1C0001
100101
100001
1C1001
100001
101001
1000C1
100101
100001
101101
100001
100001
1011C1
100001
100001
100001
100001
100001
100001
100001
101101
100001
101101
1C0001
111111
