1111111
10000C1
1111001
1P00EE1
1111111
