1111111
10000C1
1111001
1PP00E1
1111111
