1111111
1000001
1111001
1P000E1
1111111
