1111111
10000C1
1111001
10000E1
1111111
