1111111111
10010000C0
1000111001
1P000000E1
1111111111
