1111110111
10010000C1
1000111001
1P000000E1
1111111111
